#####
#...#
#...#
#...#
#.###
#.#
.P.
